111111111111111111111111111
1PCCCCCCCCCCCCCCCCCCCCCCCE1
111111111111111111111111111