111111111
100C00001
1E1111101
101000001
111P11101
111111101
1111111C1
111111111